................
...XXXX.........
...X..X.........
...X..X.........
...XXXX.........
................
...........XX...
...........X....
................
................
................
.XX.............
..X.............
.XX.............
................
